"filename", "language", "CSS", "JavaScript", "comment", "blank", "total"
"c:\Code\Tourney\src\Answer.css", "CSS", 13, 0, 0, 1, 14
"c:\Code\Tourney\src\Answer.js", "JavaScript", 0, 36, 0, 6, 42
"c:\Code\Tourney\src\App.js", "JavaScript", 0, 75, 0, 45, 120
"c:\Code\Tourney\src\Create.css", "CSS", 89, 0, 1, 14, 104
"c:\Code\Tourney\src\Create.js", "JavaScript", 0, 232, 13, 96, 341
"c:\Code\Tourney\src\CreateDecider.js", "JavaScript", 0, 47, 2, 20, 69
"c:\Code\Tourney\src\Game.css", "CSS", 113, 0, 0, 24, 137
"c:\Code\Tourney\src\Game.js", "JavaScript", 0, 193, 13, 64, 270
"c:\Code\Tourney\src\Host.css", "CSS", 30, 0, 0, 4, 34
"c:\Code\Tourney\src\Host.js", "JavaScript", 0, 130, 0, 47, 177
"c:\Code\Tourney\src\Made.css", "CSS", 20, 0, 0, 4, 24
"c:\Code\Tourney\src\Made.js", "JavaScript", 0, 64, 4, 23, 91
"c:\Code\Tourney\src\Matchups.js", "JavaScript", 0, 71, 1, 27, 99
"c:\Code\Tourney\src\Menu.js", "JavaScript", 0, 87, 0, 33, 120
"c:\Code\Tourney\src\PostQ.css", "CSS", 4, 0, 0, 2, 6
"c:\Code\Tourney\src\PostQ.js", "JavaScript", 0, 48, 18, 13, 79
"c:\Code\Tourney\src\PreHost.css", "CSS", 65, 0, 2, 15, 82
"c:\Code\Tourney\src\PreHost.js", "JavaScript", 0, 104, 2, 43, 149
"c:\Code\Tourney\src\Question.js", "JavaScript", 0, 64, 8, 25, 97
"c:\Code\Tourney\src\RankTable.js", "JavaScript", 0, 40, 4, 12, 56
"c:\Code\Tourney\src\Ranking.js", "JavaScript", 0, 95, 4, 32, 131
"c:\Code\Tourney\src\app.css", "CSS", 189, 0, 4, 38, 231
"c:\Code\Tourney\src\bracket.js", "JavaScript", 0, 47, 3, 27, 77
"c:\Code\Tourney\src\firebase.js", "JavaScript", 0, 13, 19, 13, 45
"c:\Code\Tourney\src\index.js", "JavaScript", 0, 17, 4, 5, 26
"Total", "-", 523, 1363, 102, 633, 2621